s00111111100000
100000110001110
111110000111110
100001101111110
101111101111111
100000000000000
111111101111110
000000000000000
111100111111111
111110000000000
000010110111110
011010110111000
010010110111011
011110110111000
00000011011111f
